mmmmmmmmmmmm
m..........m
m..........m
m.....s....m
m..........m
m..........m
m..........m
m..........m
m.....e....m
m..........m
m..........m
mmmmmmmmmmmm